#NAME=Boom?
#AUTHOR=Grym
#BG_COLOR=70, 130, 180
#WIDTH=9
#HEIGHT=40


05,00,00,16,16,16,00,00,05
05,00,00,00,00,00,00,00,05
00,00,00,00,00,00,00,00,00
00,00,00,00,00,00,00,00,00
00,00,00,00,00,00,00,00,00
00,00,00,00,00,00,00,00,00
00,00,00,00,00,00,00,00,00
00,00,00,00,00,00,00,00,00
00,00,00,00,00,00,00,00,00
31,00,00,00,00,00,00,00,31
07,21,00,00,00,00,00,21,07
00,00,00,00,00,00,00,00,00
00,00,00,00,00,00,00,00,00
00,00,00,00,00,00,00,00,00
00,00,00,00,00,00,00,00,00
00,00,00,00,00,00,00,00,00
00,00,00,00,00,00,00,00,00
00,00,00,00,00,00,00,00,00
00,00,00,00,00,00,00,00,00
00,00,00,00,00,00,00,00,00
00,00,00,07,07,07,00,00,00
00,07,00,07,07,07,00,07,00
00,01,01,43,43,43,01,01,00
00,01,01,02,02,02,01,01,00
00,01,01,02,02,02,01,01,00
31,21,21,07,07,07,21,21,31
31,21,21,07,07,07,21,21,31
31,07,00,00,00,00,00,07,31
07,00,00,00,00,00,00,00,07
00,00,00,00,00,00,00,00,00
00,00,00,00,00,00,00,00,00
00,00,00,00,00,00,00,00,00
00,00,00,00,00,00,00,00,00
00,00,00,00,00,00,00,00,00
00,00,00,00,00,00,00,00,00
00,00,00,00,00,00,00,00,00
00,00,00,00,00,00,00,00,00
00,00,00,00,00,00,00,00,00
00,00,00,00,00,00,00,00,00
00,00,00,00,00,00,00,00,00