#NAME=Grey is too hard
#AUTHOR=Grym
#BG_COLOR=70, 130, 180
#WIDTH=9
#HEIGHT=9


00,00,00,00,00,00,00,00,00
00,00,00,00,00,00,00,00,00
00,00,00,00,00,00,00,00,00
00,00,00,00,00,00,00,00,00
00,00,00,00,00,00,00,00,00
00,00,00,00,04,04,04,41,41
00,00,00,00,00,00,04,04,01
00,00,00,00,00,00,00,04,04
00,00,00,00,00,00,00,00,04