#NAME=Boom!!
#AUTHOR=Grym
#BG_COLOR=70, 130, 180
#WIDTH=9
#HEIGHT=40


00,00,00,00,00,00,00,00,00
00,00,00,00,00,00,00,00,00
00,00,00,00,00,00,00,00,00
00,00,00,00,00,00,00,00,00
07,00,00,00,00,00,00,00,00
23,07,00,00,00,00,00,00,00
07,00,00,00,00,00,00,00,00
00,00,00,00,00,00,00,00,00
00,00,00,00,00,00,00,00,00
00,00,00,00,00,00,00,00,00
00,00,00,00,00,00,00,00,00
00,00,00,00,00,00,00,00,00
00,00,00,00,00,00,00,00,00
00,00,00,00,00,00,00,00,00
00,00,00,00,00,00,00,00,00
00,00,00,00,00,00,00,00,00
01,01,01,01,01,01,01,01,01
01,01,31,11,11,11,21,01,01
42,42,07,07,07,07,07,42,42
07,07,07,07,07,07,07,07,07
00,00,00,00,00,00,00,00,00
00,00,00,00,00,00,00,00,00
00,00,00,00,00,00,00,00,00
00,00,00,00,00,00,00,00,00
00,00,00,00,00,00,00,00,00
00,00,00,00,00,00,00,00,00
00,00,00,00,00,00,00,00,00
00,00,00,00,00,00,00,00,00
00,00,00,00,00,00,00,00,00
00,00,00,00,00,00,00,00,00
00,00,00,00,00,00,00,00,00
00,00,00,00,00,00,00,00,00
00,00,00,00,00,00,00,00,00
00,00,00,00,00,00,00,00,00
00,00,00,00,00,00,00,00,00
00,00,00,00,00,00,00,00,00
00,00,00,00,00,00,00,00,00
00,00,00,00,00,00,00,00,00
00,00,00,00,00,00,00,00,00
00,00,00,00,00,00,00,00,00