#NAME=Weird?
#AUTHOR=Grym
#BG_COLOR=70, 130, 180
#WIDTH=9
#HEIGHT=9


00,00,00,00,00,00,00,00,00
00,00,00,00,00,00,00,00,00
00,00,00,00,00,00,00,00,00
00,00,00,00,00,00,00,00,00
00,00,00,00,00,00,00,00,00
00,00,00,05,05,05,00,00,00
04,00,00,05,05,05,00,00,04
22,00,00,06,06,06,00,00,22
11,00,00,00,00,00,00,00,11